SO /Users/jvillefr/curs42/test-proj/textures/minecraft/diamond.png
NO /Users/jvillefr/curs42/test-proj/textures/minecraft/diamond.png
WE /Users/jvillefr/curs42/test-proj/textures/minecraft/diamond.png
EA /Users/jvillefr/curs42/test-proj/textures/minecraft/diamond.png

F 0,102,0
C 0,70,200
1111111
100N00111
1000000011
1000000011
100000111
1111111
