SO /Users/anshimiy/Desktop/toPush/cub3d_again/textures/wolfenstein/Wall1.png
NO /Users/anshimiy/Desktop/toPush/cub3d_again/textures/wolfenstein/Wall2.png
WE /Users/anshimiy/Desktop/toPush/cub3d_again/textures/wolfenstein/Wall3.png
EA /Users/anshimiy/Desktop/toPush/cub3d_again/textures/wolfenstein/Wall4.png

F 0,102,0
C 0,70,200







1111111111111111111111111111111111111111111111111111111111      1111111111111111111111111111111111111111111111111111111111
10000000000000000000000000000000000000000000000000000000011111111000000000000000000000000000000000000000000000000000000001
10000000001000000000000000000000001000000000011011100000000000000000000000000000100000000000000000000000000000000000000001
10000000000000000000000000000100000000000000000000000000011111111000000000000000001000000000000000000000000000000000100001
1000000000000000000000000000010000000000000000001000000001      1000000000000000000100000000000000000000000000000000100001
1000000000000000000000000000010000000000000000000000000001      1000000100000000000000000000000000100000000000000000100001
1000000000000000000001000000010000000000000000000000000001      1000000100000000000011000000000000000000000000000000000001
1000000000000000000000000000000000000000000000000000000001      1000000100000000000000000000001000000000000000000000000001
1000000000100000000000000000000000000000001000000000000001      1000000000000000000000000000000000000000001000000100000001
1000000000000000000000000000000000000000000000000000000001      1000000010000000000000000000000000000000000000000000000001
1111111111111111111111000000000000011111111111111111111111      1111111111111111111111000000000000011111111111111111111111
                     100000101000001                                                 100000101000001
                     100010000010001                                                 100010000010001
                     100010000010001                                                 100010000010001
                     100000111000001                                                 100000111000001
1111111111111111111111000000000000011111111111111111111111      1111111111111111111111000000000000011111111111111111111111
1000000000000000000000000000000000000000000000000000000001      1000000000000000000000000000000000000000000000000000000001
1000000000000000000000000000000000000000000000000000000001      1000000000000000000000000010000000000000000000000000000001
1000000000000010000000000000011111000000000000000000000001      1000000000100000000000000000000000000000000000110000000001
1000000010000000000000000000000000000000000000000000000001      1010000000000000000000000000000000100000000000000000000001
10000000000000000000000000000000000000000100000000000000011111111000000000000000000000000000000000000000000000000000000001
10000000000000000000000000000000000000000100000000100000000000000000000001000000000000010000000000000000000000000000000001
10000001000000000000000111110000000000000100000000000000011111111000000001000000000000000000000000000000000000000000000001
1000000100000000000000000000000000000000010000001000000001      1000000001000000000000000000000000000000000000000010000001
10000001000000000000000000000N0000000000000000000000000001      1000000001000000000000000000000000000000000000000000000001
1000000000000000110000000000000000000001000000000000000001      1000000001000000000010000000000000000010000000000000000001
1000000000000000000000000000000000000000000000001000000001      1000000000000000000000000000010000000000000000000000000001
1000000000000000000000000000000000000000000000000000000001      1000000000000000000000000000000000000000000000000000000001
1111111111111111111111111111111111111111111111111111111111      1111111111111111111111111111111111111111111111111111111111